EA images/big.tga
WE images/big.tga
SO images/big.tga
NO images/big.tga
F 255,255,0
C 0,0,255
cub 1 wall default_east default_south default_west default_north
cub 0 space default_wall default_wall
cub P space default_wall _ object player 0
cub P space default_wall _ object player 225
cub E exit default_wall default_wall default_wall default_wall
cub D space default_wall _ object prop 270 dummy
cub D space default_wall _ object npc gunner 270 2

111111111111111111111111111
1DDDDDDDDDDDDDDDDDDDDDDDDD1
1DDDDDDDDDDDDDDDDDDDDDDDDD1
1DDDDDDDDDDDDDDDDDDDDDDDDD1
1DDDDDDDDDDDDDDDDDDDDDDDDD1
1DDDDDDDDDDDDDDDDDDDDDDDDD1
1DDDDDDDDDDDDDDDDDDDDDDDDD1
1DDDDDDDDDDDDDDDDDDDDDDDDD1
1DDDDDDDDDDDDDDDDDDDDDDDDD1
1DDDDDDDDDDDDDDDDDDDDDDDDD1
1DDDDDDDDDDDDDDDDDDDDDDDDD1
1DDDDDDDDDDDDDDDDDDDDDDDDD1
1DDDDDDDDDDDDDDDDDDDDDDDDD1
1DDDDDDDDDDDDDDDDDDDDDDDDD1
1DDDDDDDDDDDDDDDDDDDDDDDDD1
1DDDDDDDDDDDDDDDDDDDDDDDDD1
1DDDDDDDDDDDDDDDDDDDDDDDDD1
1DDDDDDDDDDDDDDDDDDDDDDDDD1
1DDDDDDDDDDDDDDDDDDDDDDDDD1
1DDDDDDDDDDDDDDDDDDDDDDDDD1
1DDDDDDDDDDDDDDDDDDDDDDDDD1
1DDDDDDDDDDDDDDDDDDDDDDDDD1
1DDDDDDDDDDDDDDDDDDDDDDDDD1
1DDDDDDDDDDDDDDDDDDDDDDDDD1
1DDDDDDDDDDDDDDDDDDDDDDDDP1
111111111111111111111111111
